LGGNEQVTR	iRT
SALPSNWK	LCI5
SVLPANWR	LCI5
DTDILAAFR	rbcL
EVTLGFVDLMR	rbcL
FLFVAEAIYK	rbcL
LTYYTPDYVVR	rbcL
AYVSNESAIR	RBCS2
LVAFDNQK	RBCS2
YWTMWK	RBCS2
AFPDAYVR	RBCS2
VPLILGIWGGK	RCA1
IGQQLVNAR	RCA1
SLVDEQENVK	RCA1
LGADSGALEFVPK	PCY1
DDYLNAPGETYSVK	PCY1
TPLANLVYWK	psaB
ALYGFDFLLSSK	psaB
TNFGIGHR	psaB
LSIFETGIK	atpB
TAPAFVDLDTR	atpB
IPAGPDLIVK	petA
NILVVGPVPGK	petA
IVAITALSEK	petA
YPIYFGGNR	petA
LYSIASSR	FNR1
LDYALSR	FNR1
VLNTWADIINR	D1
EWELSFR	D1
NTWADIINR	D1
LIFQYASFNNSR	D1
TALPADWR	LCI5
LVFPEEVLPR	psbD
NILLNEGIR	psbD
TWFDDADDWLR	psbD
ADLNVPLDK	PGK
TFNDALADAK	PGK
LSELLGKPVTK	PGK
AVSLVLPSLK	Gap3
VLITAPAK	Gap3
ALQNTVLK	FBA3
VMFEGILLK	FBA3
SVVSIPHGPSIIAAR	FBA3
VPLFIGSK	FBP1
TLLYGGIYGYPGDAK	FBP1
IYSFNEGNYGLWDDSVK	FBP1
LTNITGR	SBP
LLFEALK	SBP
FLAIDAINK	TRK1
VSTLIGYGSPNK	TRK1
NPDFFNR	TRK1
FIESQVAK	RPE1
GVNPWIEVDGGVTPENAYK	RPE1
SDIIVSPSILSADFSR	RPE1
IYLDISDDIK	PRK1
VAELLDFK	PRK1
GHSLESIK	PRK1
SLFGESNEVVAK	TPI1
LVDELNAGTIPR	TPI1
LANLPEVK	RPI1
LQNIVGVPTSIR	RPI1
TQLSQDELK	RPI1
SGQPAVDLNK	DP12
ASGQPAVDLNK	DP12
AEAALLVR	RMT1
SNSTPLGSR	RMT1
GILASDESNATTGK	FBA1
ALQSSTLK	FBA1
VSAADVAR	FBA2
ALQASVLK	FBA2
VTEAAALASGR	Cre07.g338451
NLALELVR	FBP1
SAEGLDASASLR	CalSciex
